{
"tiles" : [ [0, 0, 0, 1, 1, 1, 0, 0, 0 ],
            [0, 0, 0, 1, 1, 1, 0, 0, 0 ],
            [0, 0, 0, 1, 1, 1, 0, 0, 0 ],
            [0, 1, 1, 1, 1, 1, 1, 1, 0 ],
            [0, 1, 1, 1, 1, 1, 1, 1, 0 ],
            [0, 1, 1, 1, 1, 1, 1, 1, 0 ],
            [0, 0, 0, 1, 1, 1, 0, 0, 0 ],
            [0, 0, 0, 1, 1, 1, 0, 0, 0 ],
            [0, 0, 0, 1, 1, 1, 0, 0, 0 ] ],

  "targetScore" : 3000,
  "moves" : 100,
}
