{
  "tiles" : [ [0, 1, 1, 1, 1, 1, 1, 1, 0 ],
              [1, 0, 1, 1, 1, 1, 1, 0, 1 ],
              [1, 1, 0, 1, 1, 1, 0, 1, 1 ],
              [1, 1, 1, 0, 1, 0, 1, 1, 1 ],
              [1, 1, 1, 1, 0, 1, 1, 1, 1 ],
              [1, 1, 1, 0, 1, 0, 1, 1, 1 ],
              [1, 1, 0, 1, 1, 1, 0, 1, 1 ],
              [1, 0, 1, 1, 1, 1, 1, 0, 1 ],
              [0, 1, 1, 1, 1, 1, 1, 1, 0 ] ],

  "targetScore" : 2000,
  "moves" : 70,
}
